**********
*      * E
*      * *
*        *
*S********
